##########           ##########

##########
#
#
#    #   ###########
####        ######

#############
#########
                      #########
#########

