#################################
#################################
#################################
###########           ###########
##########          # ###########
##################### ###########
######         ###### ###########
#####              ## ###########
######        ####### ###########
######         ###### ###########
##################### ###########
##########
#
#                   #
            ########
####        ######     ########
                       #      #
#############          #      #
#########
   #                  #########
# #######
           #############

################## ##############
