   

#
#
            ########
####        ######

#############
#########
   #                  #########
# #######
           #############

################## ##############
