   

#
#
            ########
####        ######

#############
#########
                      #########
#########


#######################################
