  ##############################   
             ################### 
############                  ##
############ ##############   ##
############ ###################
############ ###################
############  ################## 
#############              #####
############## #################
############## #################
############## #################
############## #################
##             #################
########## #####################
########## ######          #####
##     ### ######          #####
##     ### ######          #####
##     ### ############### #####
##     ### ############### #####
##     ### ############### #####
#### ##### ############### #####
#### #####                 #####
#### ############## ############
####                ############
